{
  "row": 8,
  "col": 8,
  "color": 4,
  "level": [
    [0, 0, 14, 0, 0, 0, 0, 0],
    [0, 0, 0, 0, 0, 0, 0, 0],
    [0, 0, 0, 0, 0, 0, 0, 0],
    [0, 0, 132, 0, 132, 0, 0, 0],
    [0, 0, 0, 0, 0, 0, 0, 0],
    [0, 0, 132, 0, 0, 0, 0, 0],
    [0, 0, 15, 15, 15, 0, 0, 0],
    [0, 0, 0, 0, 0, 0, 0, 0]
  ],
  "boards": [
    [0, 0, 0, 0, 0, 0, 0, 0],
    [0, 1, 1, 1, 1, 1, 1, 0],
    [0, 1, 0, 0, 0, 0, 1, 0],
    [0, 1, 0, 0, 0, 0, 1, 0],
    [0, 1, 0, 0, 0, 0, 1, 0],
    [0, 1, 0, 0, 0, 0, 1, 0],
    [0, 1, 1, 1, 1, 1, 1, 0],
    [0, 0, 0, 0, 0, 0, 0, 0]
  ],
  "goal": 2
}