{
  "number": 1,
  "row": 8,
  "col": 8,
  "color": 6,
  "level": [
    [512, 512, 2, 5, 5, 4, 512, 512],
    [512,   3, 5, 4, 2, 3, 4,   512],
    [1,     2, 15, 15, 15, 15, 3,     5],
    [2,    0, 15, 512, 512, 15, 4,    4],
    [3,    3, 15, 512, 512, 15, 1,    3],
    [1,     2, 15, 15, 15, 15, 5,     4],
    [512,   0, 5, 3, 4, 4, 0,   512],
    [512, 512, 5, 4, 5, 4, 512, 512]
  ],
  "boards": [
    [0, 0, 0, 0, 0, 0, 0, 0],
    [0, 1, 1, 1, 1, 1, 1, 0],
    [0, 1, 0, 0, 0, 0, 1, 0],
    [0, 1, 0, 0, 0, 0, 1, 0],
    [0, 1, 0, 0, 0, 0, 1, 0],
    [0, 1, 0, 0, 0, 0, 1, 0],
    [0, 1, 1, 1, 1, 1, 1, 0],
    [0, 0, 0, 0, 0, 0, 0, 0]
  ],
  "goals": {
    "stone": 5,
    "2": 10
  },
  "step": 15,
  "stars": {
    "star1": 3000,
    "star2": 6000,
    "star3": 10000
  }
}
